gfx/tiles.png 12 12 64
4 3 3 3 3 3 3 3 3 3 3 4
4 0 0 0 0 0 0 0 0 0 0 4
4 0 0 0 0 0 0 0 0 0 0 4
4 0 0 5 0 0 0 0 0 5 0 4
4 0 0 0 0 0 0 0 0 0 0 4
4 0 0 0 0 0 0 0 0 0 0 4
4 0 0 0 0 0 0 0 0 0 0 4
4 0 0 0 0 0 0 0 0 0 0 4
4 0 0 0 0 0 0 0 0 0 0 4
4 0 0 0 0 0 0 0 0 0 0 4
4 4 4 0 5 4 4 4 4 4 4 4
4 4 4 0 0 3 3 3 3 3 3 3
